#####################
# Picture Directory #
#####################
analyse: "analyse-anzeigen2" appears when using the Magic Lens on an enemy.
anzeige: General Menu Stuff
axttech: Axe Techs
band: Armbands
beschreib: Descriptions (Covers: Abilities (Non-Techs), item, gefecht, haltung)
beschr-ruest: Equipment Descriptions (Covers: waffe, Band, Ruest, hut, zubehoer, sonstiges)
credits: Credits (at the very end)
gefecht: Battle Signums (Has a "G-" prefix in beschreib), seems to be your typical magic spells. Signum spells from leveling up offensive elements.
gladius: Sword Arts
haltung: Auxiliary Signums (Has a "H-" prefix in beschreib), seems to be giving status effects to targets. Signum spells from leveling up defensive elements.
handel: Tradables
Handeln-Text: Trading Menus
hut: Helmets
Intro_Seldan-Text: Opening Text + End of Prologue
Intro2-Text: Overture
Intro-Text: Opening Logo + Lore?
item: Consumables
KAUFEN: Trading Menu Stats + Checkout Text
kugel: Elements
lvlup_stat
menu
ObjektHandel: Traded Messages
Pseudo_minenausruest
Ruest: Armor
Sieg-Menu: Post-Battle Menu
sonstiges: Other
speerkunst: Spear Arts
Spiel-Start-ID: "Enter A Number"
System
SZENE: Scene Fancy Text
tech: Techs
turnier: Tournament Teams
tutorial-pic: Appears during interactions with Yahenru (which I assume is a tutorial NPC).
velsystem: Vel-System
VERKAUFEN: Trading Sell Menu
vor_credits: Opening Credits
Waf_Kateg: Weapon Types
waffe: Weapons
wahl: Battle Menu Options
worldmap: Locations
zielwahl: Enemies
zubehoer: Accessories
zustand: Status Effects (shown above the affected character)



##########
# Common #
##########
-= Elements =-
Erde: Earth
Feuer: Fire
Licht: Light
Schatten: Shadow
Wasser: Water
Wind: Wind

-= Stats =-
Angriff: Attack (ATK)
Schutz/Abwehr: Defense (DEF)
Mental: Wisdom (WIS)
Agilität: Agility (AGL)
HP: HP
MP: MP

-= Equipment Types =-
Waffe: Weapon
Armband: Armband
Rüstung: Armor
Helm: Helmet
Zubehör: Accessories

-= Weapon Types =-
Äxte: Axes
Lanzen: Lances
Schwerter: Swords

-= Status Effects =-
Animoschild: Animo Shield
Agilität: Agility
Angriff: Attack
Mental: Wisdom
Reflex: Evasion
Schutz: Defense
Treffer: Accuracy
Blendung: Glare
Ferresschild: Ferres Shield
Konter!: Counter!
Nebelgewand: Mist Robe
Paralyse: Paralysis
Schlaf: Sleep
!Shield Break!: !Shield Break!
Spiegelung: Reflect
Sprint: Zeal
Stand canceled: Stand Cancel (Stand Cancelled)
Stummheit: Silence
Trägheit: Torpor
Vergiftung: Poison
Verwirrung: Confusion



#############
# Abilities #
#############
-= Techs =-
3-Klingen-Tech: The Triblader
Berserkers Wut: Berserker Rage ("Berserker's Wrath" doesn't fit.)
Blutsauger: Bloodsucker
Dampfwolke: Steam Cloud
Das Ende: The Finale ("The Grand Finale" doesn't fit.)
Flug-Beutel: Flying Bag
Giftwolkenflug: Poison Clouds
Harpyienblitz: Harpy Thunder
Himmelsstroßer: Divine Strike
Raiken: Raiken
Raubzug: Raid
Reißzahn: Fang
Viaexillum: Viaexillum
Wohltäter-Sturm: Spirit Tempest
Wurfmesser: Throwing Knives
Zinkar-Combo: Zinkar Combo
Funkenschwung: Volcanic Swipe (It's some sort of explosive imbuing, not electric, which would've been "Hyperstatic Swing". "Volcanic Uppercut" doesn't fit in the box.)
Stolperstich: Staggering Blow
Todesgemetzel: Massacre


-= Spear Arts =-
3er Combo: 3-Point Combo
3 physische Schläge gegen ein Ziel - Three physical strikes against a target.

Deltastich: Delta Strike
Zwei starke, physische Treffer gegen ein Ziel - Two strong, physical hits against a target.


-= Axe Arts =-
Flugbeil: Flying Axe
Ein mächtiger Axtwurf auf einen Gegner - A powerful axe throw at a target.

Kreuzspalter: Cross Splitter
**Has the same description as Delta Strike**


-= Sword Arts (Offline) =-
Schallschwung: Sonar Sweep
Ein schneller und kräftiger Schwerthieb - A quick and powerful sword attack.

Lichtspirale: Spiral of Light
Physischer Licht-Schaden auf alle Gegner - Physical light damage to all enemies.


-= Vel-System =-
Lucislasus: Lucislasus
Ein mächtiger Schlag aus schwindelnder Höhe. - A powerful strike from a blinding height.


-= Gefechts-Signum =-
**Warning** All of the shadow battle signums have different backgrounds to avoid clearing part of the element ball.
***sare - Imbue ***
***res - Great *** / Arch***
***entus - Grand *** / Ulti***

Anti-Mentalsare: Imbue Chaos
Schaden steigt, wenn Ziel wenig MP besitzt - Increases damage when the target has low MP.

Blinsare: Imbue Glare
Verursacht Blendung bei einem Ziel - Inflicts glare on a target.

Blutsare: Imbue Blood
Größerer Schaden, dafür Verlust von eigenen HP - Increases damage but you sacrifice some HP.

Erde: Earth
Leichter, erd-elementarer Schaden - Slight earth elemental damage.

Erdentus: Grand Earth

Erdsare: Imbue Earth
Ein erd-elementarer Angriff mit der Waffe - A physical earth elemental attack.

Erdres: Great Earth

Feures: Great Fire

Feuentus: Grand Fire

Feuer: Fire
Leichter, feuer-elementarer Schaden - Slight fire elemental damage.

Feusare: Imbue Fire
Ein feuer-elementarer Angriff mit der Waffe - A physical fire elemental attack.

Furorsare: Imbue Frenzy
Schaden steigt, wenn Angreifer wenig HP besitzt - Increases damage when the target has low HP.

Gifsare: Imbue Poison
Verursacht Vergiftung bei einem Ziel - Inflicts poison on a target.

Konfusare: Imbue Confusion
Verursacht Verwirrung bei einem Ziel - Inflicts confusion on a target.

Lichtres: Great Light

Lichentus: Grand Light

Licht: Light
Leichter, licht-elementarer Schaden - Slight light elemental damage.

Lichtsare: Imbue Light
Ein licht-elementarer Angriff mit der Waffe - A physical light elemental attack.

Listsare: Imbue Overdrive
Größerer Schaden, dafür geringere Trefferchance - Increases damage but with less accuracy.

Multischlagsare: Imbue Multihit
Mehrere, schwächere Treffer nach dem Schlag - Multiple weaker hits after the initial strike.

Paralysare: Imbue Paralysis
Verursacht Paralyse bei einem Ziel - Inflicts paralysis on a target.

Rauschsare: Imbue Vortex
Schaden abhängig von der Anz. der SP der Party - Damage depending on the amount of SP in the party.

Rückschlagsare: Imbue Distortion
Treffer schlägt den Gegner zeitlich etwas zurück - Slows the target in time for a bit.

Schallsare: Imbue Swiftness
Kleinerer Schaden, dafür kürzere Wartezeit - Decreases damage but with shorter waiting times.

Schattres: Great Shadow

Schatten: Shadow
Leichter, schatten-elementarer Schaden - Slight shadow elemental damage.

Schattentus: Grand Shadow

Schattsare: Imbue Shadow
Ein schatten-elementarer Angriff mit der Waffe - A physical shadow elemental attack.

Schlafsare: Imbue Sleep
Verursacht Schlaf bei einem Ziel - Inflicts sleep on a target.

Schmettersare: Imbue Demolisher
Schaden durchdringt den Schutz des Gegners - Damage that ignores the target's defense.

Stummsare: Imbue Silence
Verursacht Stummheit bei einem Ziel - Inflicts silence on a target.

Vitalsare: Imbue Vitality
Kleinerer Schaden, dafür Heilung der eigenen HP - Decreases damage but you recover some HP.

Wassare: Imbue Water
Ein wasser-elementarer Angriff mit der Waffe - A physical water elemental attack.

Wassentus: Grand Water

Wassres: Great Water

Wasser: Water
Leichter, wasser-elementarer Schaden - Slight water elemental damage.

Wind: Wind
Leichter, wind-elementarer Schaden - Slight wind elemental damage.

Windentus: Grand Wind

Windsare: Imbue Wind
Ein wind-elementarer Angriff mit der Waffe - A physical wind elemental attack.

Windres: Great Wind

Wuchtsare: Imbue Force
Größerer Schaden, dafür längere Wartezeit - Increases damage but with longer waiting times.

Zielsare: Imbue Clarity
Kleinerer Schaden, dafür höhere Trefferchance - Decreases damage but with greater accuracy.


-= Haltungs-Signum =-
Abwehr-Fokus: Focus Defense
Erhöht den Schutz eines Ziels - Increases the defense of a target.

Abwehr-Senker: Sap Defense
Senkt den Schutz eines Ziels - Decreases the defense of a target.

Agilitäts-Fokus: Focus Agility
Erhöht die Agilität eines Ziels - Increases the agility of a target.

Agilitäts-Senker: Sap Agility
Senkt den Agilität eines Ziels - Decreases the agility of a target.

Animoschild: Animo Shield

Besserung: Revitalize
Heilt Verwirrung, Stummheit und Schlaf - Gets rid of confusion, silence, and sleep.

Curia: Heal
Heilt eine kleine Menge an HP von einem Ziel - Heals someone for some HP.

Ferresschild: Ferres Shield

Genesung: Cure
Heilt alle negativen Zustände - Gets rid of all negative status effects.

Medikation: Mend
Heilt Vergiftung, Blendung und Paralyse - Gets rid of poison, glare, and paralysis.

Mental-Fokus: Focus Wisdom
Erhöht die mentale Kraft eines Ziels - Increases the wisdom of a target.

Mental-Senker: Sap Wisdom
Senkt die mentale Kraft eines Ziels - Decreases the wisdom of a target.

Nebelgewand: Mist Robe

Reflex-Fokus: Focus Evasion
Erhöht die Ausweichrate eines Ziels - Increases the evasion of a target.

Reflex-Senker: Sap Evasion
Senkt die Ausweichrate eines Ziels - Decreases the evasion of a target.

Spiegelung: Reflect

Sprint: Zeal
Hebt die Geschwindigkeit eines Ziels - Increases the speed of a target.

Stärke-Fokus: Focus Strength
Erhöht die Angriffskraft eines Ziels - Increases the strength of a target.

Stärke-Senker: Sap Strength
Senkt die Angriffskraft eines Ziels - Decreases the strength of a target.

Trägheit: Torpor
Senkt die Geschwindigkeit eines Zeils - Decreases the speed of a target.

Treffer-Fokus: Focus Accuracy
Erhöht die Trefferquote eines Ziels - Increases the accuracy of a target.

Treffer-Senker: Sap Accuracy
Senkt die Trefferquote eines Ziels - Decreases the accuracy of a target.



#########
# Items #
#########
-= Consumables =-
Abwehrtrank: Defense Potion
Erhöht Schutz und schwächt Agilität eines Ziels - Increases defense and decreases agility.

Agilitätstrank: Agility Potion
Erhöht Agilität und schwächt Schutz eines Ziels - Increases agility and decreases defense.

Ambrosia: Ambrosia
Heilt jeden in der Party um ca. 250 HP - Heals everyone in the party for around 250 HP.

Blitzbombe: Lightning Bomb

Dynamit: Dynamite

Gegengift: Antidote
Kuriert Vergiftung bei einem Ziel - Cures poison.

Giftbombe: Poison Bomb

Heilessenz: Heal Essence
Heilt ca. 100 HP von einem Ziel - Heals someone for around 100 HP.

Heilextrakt: Heal Extract

Heilgemme: Heal Gem
Heilt jeden in der Party um ca. 40 HP - Heals everyone in the party for around 40 HP.

Heilkristall: Heal Crystal
Heilt jeden in der Party um ca. 120 HP - Heals everyone in the party for around 120 HP.

Heilsirup: Heal Syrup
Heilt ca. 50 HP von einem Ziel - Heals someone for around 50 HP.

Konfusbombe: Confusion Bomb

Kühlkraut: Cold Herb
Kuriert Verwirrung bei einem Ziel - Cures confusion.

Lichtschlag: Divine Light
Macht einen Gefallenen wieder kampffähig - Revives a fallen party member.

Magische Lupe: Magic Lens
Eine Lupe, die den Status eines Gegners anzeigt - A magnifying glass that shows an enemy's status.

Mentaltrank: Wisdom Potion
Erhöht Mentalität und schwächt Stärke eines Ziels - Increases wisdom and decreases strength.

Mentaltropfen: Mana Droplets
Heilt ca. 50 MP von einem Ziel - Recovers around 50 MP for someone.

Rauchbombe: Smoke Bomb

Reflextrank: Evasion Potion
Erhöht Reflex und schwächt Treffer eines Ziels - Increases evasion and decreases accuracy.

Schallwurzel: Sound Root
Kuriert Stummheit bei einem Ziel - Cures silence.

Schattenhauch: Shadow Breath
Kuriert Blendung bei einem Ziel - Cures glare.

Schlafbombe: Sleep Bomb

Schockmittel: Shock Tonic
Kuriert Schlaf bei einem Ziel - Cures sleep.

Stärketrank: Strength Potion
Erhöht Stärke und schwächt Mentalität eines Ziels - Increases strength and decreases wisdom.

Stummbombe: Silence Bomb

Treffertrank: Accuracy Potion
Erhöht Treffer und schwächt Reflex eines Ziels - Increases accuracy and decreases evasion.

Weichpulver: Soft Powder
Kuriert Paralyse bei einem Ziel - Cures paralysis.

Wurfdolch: Throwing Knife
Physischer Schaden gegen ein Ziel - Deals physical damage to a target.


-= Tradables =-
Blauperle: Blue Pearl
Bronzetaler: Bronze Ingot
Derukusglanz: Derukus Shine
Dicker Pelz: Thick Pelt
Dünner Pelz: Thin Pelt
Edles Fell: Noble Fur
Flajo-Frucht: Flajo Fruit
GlanzSchuppe: Shiny Scale
Goldene Feder: Golden Feather
Goldperle: Gold Pearl
Goldtaler: Gold Ingot
Graue Feder: Gray Feather
Grünperle: Green Pearl
Lokri-Knolle: Lokri Potato
Matte Schuppe: Dull Scale
Panzerschale: Armored Shell
Pfeffer: Pepper
Raues Fell: Rough Fur
Repsbrot: Sunbread (Slogan: Meticulously baked to perfection using sunflour!)
Repskerne: Sunflour
Rotperle: Red Pearl
Rubin: Ruby
Salz: Salt
Saphir: Sapphire
Silbertaler: Silver Ingot
Suiko-Pflanze: Suiko Plant
Weicher Pelz: Soft Pelt
Weiches Fell: Soft Fur
Weiße Feder: White Feather



#############
# Equipment #
#############
-= Weapon =-
Besen: Broom
Improvisierte Waffe für den Notfall - An improvised weapon for emergencies.

Breitschwert: Broadsword
Ein Schwert mit breiter, scharfer Klinge - A sword with a broad, sharp blade.

Bronzespeer: Bronze Spear
Eine typische Lanzenwaffe aus Nomerea - A typical lance from Nomerea.

Eisenspeer: Iron Spear
Ein stabiler Speer aus hartem Eisen - A sturdy spear made of hard iron.

Ganzstahl-Axt: Full-Steel Axe
Eine Axt aus besonders hartem Material - An axe made of particularly hard material.

Handaxt: Handaxe
Eine kleine, handliche Axt - A small, maneuverable axe.

Kurzschwert: Short Sword
Ein einfaches, kurzes Schwert - A simple, short sword.

Lanze: Lance
Die Standard-Lanzwaffe - The standard lance.

Luftstahl-Axt: Air-Steel Axe
Eine Axt die sehr gut in der Hand liegt - An axe that fits very well in the hand.

Soporusklinge: Soporus Blade
Ein grün-bläulich leuchtendes Schwert - A turquoise, shining sword.

Spitzhacke: Pickaxe
[Cibon] Breite Spitzhacke, könnte aber auch 'ne Axt sein - Wide pickaxe, but could also be an axe.
[Kento] Lange Spitzhacke. Einer Lanze erstaunlich ähnlich - Long pickaxe. Amazingly similar to a lance.
[Soko] Mit kurzem Griff - erinnert an ein Schwert - With a short handle - reminiscent of a sword.

Streitaxt: Battle Axe
Eine breite Axt mit viel Durchschlagskraft - A broad axe with a lot of punch.

Ultioslanze: Ultimate Lance
Eine Lanze, die von Kampfeswut zeugt - A lance that shows the spirit of fighting.


-= Armband =-
Armbanduhr: Wristwatch
Beschleuningt bemerkbar - Accelerates at a noticeably fast rate.

Bronzegriff: Bronze Glove
Ein harter, bronzener Handschuh - A hard, bronze glove.

Eisenfaust: Iron Cast
Ein harter Hand- und Armschutz aus Eisen - A hard hand and arm protection made of iron.

Eisenreif: Iron Band
Ein stabiler Armreif aus gutem Eisen - A sturdy armband made of good iron.

Holzreif: Wooden Strap
Ein robuster Reif aus Holz - A tough wooden strap.

Lederband: Leather Band
Ein simples Armband aus Leder - A simple leather armband.

Minenhandschuh: Miner's Gloves
Robuste Handschuhe für Minenarbeiter - Tough gloves for miners.

Silkenreif: Silk Wrap
Ein stabiler, grünlicher Reif - A sturdy, greenish wrap.

Stoffband: Cloth Band
Ein leichtes Armband aus Stoff - A light bracelet made of cloth.


-= Armor =-
**Note** Harnisch seems to be full-plate armor while Panzer only covers the torso (metal vest).

Arbeitskleidung: Ragged Robes
Standardkleidung eines Minenarbeiters - Miner's standard clothes.

Bronzeharnisch: Bronze Armor
[REAL_Bronzpzr] Ein schwerer Plattenpanzer aus Bronze - A heavy plated suit of armor made of bronze.

Diebesgewand: Thief's Robe
Ein leichtes Gewand mit wenig Schutz - A light robe with little protection.

Eisenharnisch: Full Metal Armor
Ein stabiler Harnischaus Stahlplatten - Must've cost an arm and a leg.

Käferpanzer: Beetle Vest
Schützt besser als man denken würde. - Protects better than you'd think.

Lederharnisch: Leather Armor
[Lederreust] Ein Harnisch aus hartem Leder - Armor made of hard leather.

Lederweste: Leather Vest
Eine einfache Weste aus Leder - A simple leather vest.

Bronzepanzer: Bronze Cuirass
Ein stabiler Harnisch aus Bronzeplatten - A sturdy piece made of bronze plates.

Federweste: Feather Vest
[Stoffumhang] Eine leichte, gut gefederte Weste - A light, cushioned vest.


-= Helmet =-
Blaue Schleife: Blue Ribbon
Eine knuffige, bläuliche Schleife - A cute, bluish ribbon.

Bronzehelm: Bronze Helmet
Ein robuster Helm aus Bronze - A robust helmet made of bronze.

Eisenhelm: Iron Helmet
Ein stabiler Helm aus Eisen - A sturdy helmet made of iron.

Eisenstirnband: Iron Headband
Ein mit Eisen verstärktes Stirnband - A headband reinforced with iron.

Flügelhelm: Winged Helmet
Ein stabiler, mit Flügeln verzierter Helm - A sturdy helmet decorated with wings.

Topfhelm: Pot Helmet
[kreuzhelm] Ein Helm, der viel vom Kopf abdeckt - A helmet that covers a lot of the head.

Lederkappe: Leather Cap
Eine einfache Kappe aus Leder - A simple leather cap.

Lederstirnband: Headband (The "Leather" is omitted because of the size limit :/)
Ein leichtes Stirnband aus Leder - A light headband made of leather.

Minenhelm: Miner's Helmet
Spezialausrüstung für Minenarbeiter - Special equipment for miners.


-= Accessories =-
Agilring: Agility Ring
Anschaulich und aerodynamisch geformt - Translucent and aerodynamically shaped.

Dunkelsiegel: Dark Seal
Ein dunkel-schimmernder Anhänger - A dark, shimmering pendant.

Erdring: Earth Ring
Ein bräunlich schimmernder Ring - A shimmering brown ring.

Erdsiegel: Earth Seal
Ein brauner Anhänger - A brown pendant.

Feuerring: Fire Ring
Ein rötlich schimmernder Ring - A shimmering reddish ring.

Feuersiegel: Fire Seal
Ein roter Anhänger - A red pendant.

Furentring: Furent Ring
Ein Ring mit einem rotem Juwel. - A ring with a red jewel.

Glücksbringer: Lucky Charm
Ein funkelnder Anhänger - A sparkling pendant.

Goldring: Gold Ring
Kostbarer Ring aus hochkarätigem Gold - A precious, high quality gold ring.

Habilisring: Habilis Ring
Ein Ring mit einem blauen Juwel. - A ring with a blue jewel.

Hellsiegel: Hell Seal
Ein hell-leuchtender Anhänger - A brightly shining pendant.

Kettenschutz: Chain Shield
Ein zusätzlicher, jedoch schwerer Schutz - Some extra, but heavy protection.

Lichtring: Light Ring
Ein weißlich schimmernder Ring - A shimmering whitish ring.

Lichtsiegel: Light Seal
Ein weißer Anhänger - A white pendant.

Schattenring: Shadow Ring
Ein schwärzlich schimmernder Ring - A shimmering blackish ring.

Schattensiegel: Shadow Seal
Ein schwarzer Anhänger - A black pendant.

Schlagring: Brass Knuckles
Gibt Schlägertypen Kraft und Präzision - Gives knuckleheads strength and precision.

Silber Ring: Silver Ring
Ein glänzender Ring aus Silber - A shiny silver ring.

Wächterpendant: Guard Pendant
Für den Vorbildswächter - For the aspiring protector.

Wasserring: Water Ring
Ein bläulich schimmernder Ring - A shimmering bluish ring.

Wassersiegel: Water Seal
Ein blauer Anhänger - A blue pendant.

Windring: Wind Ring
Ein türkis schimmernder Ring - A shimmering turquoise ring.

Windsiegel: Wind Seal
Ein grüner Anhänger - A green pendant.


-= Other =-
Eisenerz: Iron Ore

Graufunkpulver: Gray Powder

Inanitaskugel: Inanitas Ball

Küken: Chick
Ein ziemlich hungriges Küken - A pretty hungry chick. Quite the bird's eye view.

Lagerschlüssel: Storage Key
Öffnet die Tür zur Lagerhalle - Opens the door to the storeroom.

Minen-Orden: Miner Medallion
Aus reinstem Eisenerz hergestellt! - Made from the purest iron ore!

Paket: Package

Riesenei: Giant Egg
Ein großes Ei, perfekt für Omelett - A big egg, perfect for making an omelette.

Turniermünze: Coins



###########
# Enemies #
###########
-= Enemies =-
Alle Gegner: All Enemies
Bergfalke: Mountain Falcon
Blauschleim: Blue Slime
Brocky: Brocky
Wilder Bär: Wild Bear
Cibon: Cibon
Eigene Party: Your Party
Fledermaus: Bat
Freier Samurai: Free Samurai
Genyu: Genyu
Gittertür: Gridded Door
Grauschweif-Eule: Gray-Tailed Owl
Grünschleim: Green Slime
Guillian: Guillian
wütender Guillian: Angry Guillian
rasender Guillian: Furious Guillian
Gurim: Gurim
Harpyie: Harpy
Hornkäfer: Horny Beetle
Jorn: Jorn
Kento: Kento
Lagunoris: Lagunoris
Moskito: Mosquito
Plotio-Strauch: Plotio Shrub
Räuber: Thief
FPM05: FPM05
Saion: Saion
Schwarzbär: Black Bear
Sedric: Sedric
Seldan: Seldan
Silvanischer Wolf: Silvan Wolf
Soko: Soko
Steinkrabbe: Stone Crab
Tentakel: Tentacle
???? Soldat: ???? Soldier
Wolf: Wolf
Yahenru: Yahenru
Zojenko-Soldat: Zojenish Soldier (because "Korzojenish Soldier" doesn't fit)

-= Tournament Teams =-
(You choose between four team names: "Zinkar-Schlächter", "Repsbrot-Truppe", "Briganten-Stolz", or "Die Verräter")
Die Bärenbrüder: The Bear Brothers
Der Chef: Da Boss (his accent will be the stereotypical mafia one, a thick Brooklyn accent, because this is a prison after all)
Die Exoten: The Exotics
Die Fejarschlitzer: The Fejar Slitters
Pauamainer Veteranen: Pauamain Veterans
Rächer der Gerechten: Avenger of the Just
Die Ritter der Nacht: The Knights of Night
Das Rudel: The Pack
Die Schattenschleicher: The Shadow Crawlers
Die Schleimigen: The Slimealgamation
Der Briganten-Stolz: The Brigantine Pride
Die Repsbrot-Truppe: The Sunbread Squad (Syndicate is too long :/)
Die Verräter: The Traitors
Die Zinkar-Schlächter: The Zinkar Butchers
TruppeTruppeTruppe: TroopTroopTroop
Der Untertage-Schreck: Terror from Below
Die Zinkar Brüder: The Zinkar Brothers



#########
# Menus #
#########
-= anzeige =-
Anzahl: Amount
MP-Kosten: MP Cost
SP-Kosten: SP Cost

-= Handeln-Text =-
Wie kann ich ihnen behilflich sein? - How may I help you?
Was hätten sie denn gerne? - What would you like to buy?
Und wie viel? - And how much?
Vielen Dank. - Thank you very much.
Was wollen sie verkaufen? - What would you like to sell?
Kaufen - Buy
Verkaufen - Sell

-= KAUFEN =-
Kosten: Cost
Restvermögen: Wallet

-= menu =-
Als nächstes gelernt wird...: The next spell you will learn is...
Fehlende Level: Levels Needed
Element(e): Element(s)
Gegenstand benutzen: Use Item
Armbänder: Armbands
Sonstiges: Other (Miscellaneous?)
Helme: Helmets
Rüstungen: Armor
Waffen: Weapons
Zubehör: Accessories
Spiel wirklich beenden?: Do you really want to end the game?
Ja: Yes
Nein: No
Gefechts-Signum: Battle Signums
Haltungs-Signum: Auxiliary Signums
Ausrüstung: Equipment
Beenden: End
Elemente: Elements
Gegenstände: Items
Optionen: Options
Fejar: Fejar
Speichern: Save
Status: Status
Techniken: Techs
Truppe: Party

-= ObjektHandel =-
Getauscht! - Traded!
Angebot - Offering...
Gegen... - For...
Für... - For...
Kaufen - Trade
Gehen - Leave
Genug - Enough
Benötigt - Requires
Anzahl - Amount
Im Inventar - In Inventory
Enter für mehr Details - Enter for more details

-= Sieg-Menu =-
Kampf erfolgreich beendet. - Battle ended successfully.
Erfolgreich die Flucht ergriffen. - Successfully fled.
Level Up - Level Up
___ erlernt! - ___ learned!

-= VERKAUFEN =-
Rest im Inventar: Remainder
Gesamtwert: Profit
Vermögen: Wallet

-= wahl =-
Abwehr: Defend
Angriff: Attack
Axt-Technik: Axe Arts
Gegenstand: Items
Gladiusartis: Sword Arts (Offline)
Scharfschuss: Crossbow?
Speer-Kunst: Spear Arts
Technik: Techs
Vel-System: Vel-System

-= Panorama =-
Hauptmenu: Main Menu
Ausrüstung: Equipment
Kaufen: Buy
Verkaufen: Sell
Verlassen: Leave
Gegenstände: Items
Im Inventar: In Inventory
Ausgerüstet: Equipped
Optionen: Options
Techniken: Techs
Wert: Value
Gegenstände: Items
Waffen: Weapons
Armbänder: Armband
Rüstungen: Armor
Helme: Helmet
Zubehör: Misc
Sonstiges: Other
Hinterlassene Gegenstände: Items Left Behind
Gefunden: Found
Gesamt: Total



########
# Misc #
########
-= analyse =-
**Note** These appear in the analysis menu (duh). A lot of them only appear when the enemy has a protective shield, such as the horny beetle (heh). "mit x-Element" and "x Treffer" are pushed all the way to the right.
mit Erde-Element: using earth
mit Feuer-Element: using fire
jeden Treffer: All Attacks
mit Licht-Element: using light
magischen Treffer: Magic Attacks
einen Treffer mit Mindestschaden von: An attack with a minimum damage of
physischen Treffer: Physical Attacks
mit Schatten-Element: using shadow
Schutzschild: Magic Shield
SCHÜTZT BEI: PROTECTS AGAINST
BRICHT NACHT: BREAKS WITH (probably NICHT, but regardless...)
Treffer(n): attack(s)
mit Wasser-Element: using water
mit Wind-Element: using wind
Verzauberungen: Enchantments
Ziel: Enemy
Status-Abwehr: Stats Resist
Element-Abwehr: Elemental Resist
Zustand-Abwehr: Effects Resist

-= beschreib =-
[Option_1-1] Held rennt bei gedrückter Entertaste. - Run by pressing Enter.
[Option_1-2] Held geht bei gedrückter Entertaste. - Walk by pressing Enter.
[tech_unknown] Keine Angaben - No Information

-= beschr-ruest =-
[Handel-extremhoch] Handelgegenstand - extrem Wertvoll
Tradable - Extremely Valuable
[Handel-gering] Handelgegenstand - geringer Wert
Tradable - Low Value
[Handel-hoch] Handelgegenstand - hoher Wert
Tradable - High Value
[Handel-mittel] Handelgegenstand - mittlerer Wert
Tradable - Average Value
[Handel-sehrhoch] Handelgegenstand - sehr hoher Wert
Tradable - Very High Value
[Handel-unbelievable] Handelgegenstand - Unglaublich Wertvoll!
Tradable - Unbelievably Valuable!

-= beschr-ruest Meta / tutorial-pic =-
ANGRIFF KONTER - ATTACK COUNTER
KRITISCH - CRITICAL (CRIT.)
REFLEX - EVASION (EVADE)
SCHWACH - VULNERABILITY (VULNER.)
SCHUTZ - DEFENSE (DEF.)
SIGNUM KONTER - SIGNUM COUNTER
TREFFER - ACCURACY (ACCUR.)
-=-=-=-
ANGRIFF - ATTACK
AUTO ANIMO - AUTO ANIMO
AUTO FERRES - AUTO FERRES
AUTO SPRINT - AUTO ZEAL
AUTO TRÄGE - AUTO TORPOR
SIGNUM STREUER - SIGNUM SCATTER

-= Info Cards =-
(Happens when you equip something with less element slots)
Überschüssige Elementkopplung wurde abgelegt. --- Excess element coupling was removed.
(New Game Menu)
Geben sie eine Nummer von 1-50 an. Diese wird im Spielstand angezeigt. --- Enter a number between 1-50. This will be shown on the save file.

-= Pseudo_minenausruest =-
Minen Ausrüst. - Mine Equipment

-= System =-
Verfolger: ___ Sek - Pursuit: ___ sec
___ erhalten. - ___ received.
Fejar erhalten. - Fejar received.
Fejar gestohlen - Fejar stolen.
Fejar gezahlt. - Fejar paid.
___ abgegeben. - ___ submitted.
Weiche vorraus! - Fork ahead!
Enter drücken! - Press Enter!
Eisenerz ___ - Iron Ore: ___
___ gefunden. - ___ found.
Behalten - Keep It
Liegen lassen - Leave It
Verdacht - Suspicion
Auffälligkeit - Attention
Betreten - Enter
Zurück - Back
Raum ist sicher - The room is safe.
Rangliste - Rankings
Turniermünze ___ - Coins ___



#######################
# Outside Picture/... #
#######################
-= Panorama =-
Bewegungs-Modus - Movement Mode
Standart-Rennen - Walking
Standart-Gehen - Running
Grafikdetails im Kampfsystem - Graphic details in combat system
Infotext im Kampfsystem - Info text in combat system
Aktiviert - Activated
Deaktiviert - Deactivated


-= Chapters (Faceset/Save_Kapitel) =-
Kapitel 1: Zurück Nach Nomerea
Kapitel 2: Ein Neuer Auftrag Beginnt
Kapitel 3: Die Weiten Des Corine-Plateaus
Kapitel 4: Erste Schritte Über Die Grenze

Chapter 1: Back To Nomerea
Chapter 2: A New Mission Begins
Chapter 3: Across The Corine Plateau
Chapter 4: First Steps Across The Border


-= CharSet =-
GEGN: ENEM (I assume it's from Gegnerische)
ATK|MNT|STZ|AGI|TRF|RFL: ATK|WIS|DEF|AGL|ACC|EVA
FERRES|ANIMO|TRÄGE|SPRINT|SPIEGEL|NEBEL: FERRES|ANIMO|TORPOR|ZEAL|MIRROR|MIST
Flucht: Flee

-= Chipset =-
AKTION: ACTION
Flucht: Flee
Verzauberung: Enchantments
Status Änderung: Buffs/Debuffs